0=0
|=1
-=1
#=2
/=3
%=4

.........................................
.........................................
.........................................
.........................................
.........................................
.........................................
.........................................
.........................................
.........................................
.........................................
.........................................
.........................................
.........................................
.........................................
.........................................
.........................................
.........................................
.........................................
.........................................
.........................................
.........................................
.........................................
.........................................
.........................................
.........................................
.........................................
.........................................
.........................................
.........................................

.........................................
.........................................
.........................................
.........................................
.........................................
.........................................
.........................................
.........................................
.........................................
.........................................
.........................................
.........................................
.........................................
.........................................
.........................................
.........................................
.........................................
.........................................
.........................................
.........................................
.........................................
.........................................
.........................................
.........................................
.........................................
.........................................
.........................................
.........................................
.........................................

#########################################
#########################################
#########################################
#########################################
##%%%%%%%%%%%%%%%%#######################
##%%%%%%%%%%%%%%%%#######################
##%%%%%%%%%%%%%%%%#######################
##%%%%%%%%%%%%%%%%#######################
##%%%%%%%%%%%%%%%%#######################
##%%%%%%%%%%%%%%%%#########///////#######
##%%%%%%%%%%%%%%%%#########///////#######
##%%%%%%%%%%%%%%%%#########///////#######
##%%%%%%%%%%%%%%%%#########///////#######
###########///#######/////////////#######
###########///#######//####///////#######
###########///#######//####///////#######
###########///#######//####///////#######
###########////////////####///////#######
###########///#############///////#######
###########///#############///////#######
###########///###########################
###########///###########################
###########///###########################
###########///###########################
###########///###########################
###########///###########################
###########///###########################
###########///###########################
###########///###########################

.........................................
.........................................
.........................................
.........................................
..*- -*.*- - - - -*......................
..|...............|......................
.. ............... .....## # # # # ##....
..|...............|.....#0.0.0.0.0.0#....
.. .............*%*.......## #.#.##. ....
..|.............%0|.....#0#.......#0#....
.. .............*.*....... ..............
..|.............%0|.....#0#.......#0#....
..*- - - -*...*- -*.....*#*..............
..................................#0#....
.........................#...............
........................#0#.......#0#....
..........................*..............
........................#0#.......#0#....
........................ ................
........................#0#.......#0#....
...........................#.#.#.#.......
........................#0.0.0.0.0.0#....
....*-*-................##.#.#.#.#.##....
....|000|................................
....*-*-.................................
.........................................
.........................................
.........................................
.........................................

.........................................
.........................................
.........................................
.........................................
..*- -*.*- - - - -*......................
..|...............|......................
.. ............... .....## # # # # ##....
..|...............|.....#...........#....
.. .............. *.......## #.#.##. ....
..|..............%|.....#.#.......#.#....
.. .............. *....... ..............
..|..............0|.....#.#.......#.#....
..*- - - - - - - -*.....*#*..............
..................................#.#....
.........................#...............
........................#.#.......#.#....
..........................*..............
........................#.#.......#.#....
........................ ................
........................#.#.......#.#....
...........................#.#.#.#.......
........................#...........#....
........................##.#.#.#.#.##....
...../...................................
.........................................
.........................................
.........................................
.........................................
.........................................

.........................................
.........................................
.........................................
.........................................
..*- -*.*- - - - -*......................
..|...............|......................
.. ............... .....## # # # # ##....
..|...............|.....#0.0.0.0.0.0#....
.. .............*.*.......## #.#.##. ....
..|.............%.|.....#0#.......#0#....
.. .............*%*....... ..............
..|.............%.|.....#0#.......#0#....
..*- - - -*...*- -*.....*#*..............
..................................#0#....
.........................#...............
........................#0#.......#0#....
..........................*..............
........................#0#.......#0#....
........................ ................
........................#0#.......#0#....
...........................#.#.#.#.......
........................#0.0.0.0.0.0#....
.......-.-.....-........##.#.#.#.#.##....
......|0 0|...|0|........................
.......-.-.....-.........................
.........................................
.........................................
.........................................
.........................................

.........................................
.........................................
.........................................
.........................................
..*- -*.*- - - - -*......................
..|%%%%%%%%%%%%%%%|......................
.. %%%%%%%%%%%%%%% ......................
..|%%%%%%%%%%%%%%.|......###########.....
.. %%%%%%%%%%%%%%.*......#.........#.....
..|%%%%%%%%%%%%%%.|......#.........#.....
.. %%%%%%%%%%%%%%.*......#.........#.....
..|%%%%%%%%%%%%%%%|......#.........#.....
..*- - - - - - - -*................#.....
...................................#.....
...................................#.....
.........................#.........#.....
.........................#.........#.....
.........................#.........#.....
.........................#.........#.....
.........................#.........#.....
.........................#.........#.....
.........................###########.....
.........................................
......./......./.........................
.........................................
.........................................
.........................................
.........................................
.........................................

.........................................
.........................................
.........................................
.........................................
..*- - - - - - - -*......................
..|...............|......................
.. ............... ......................
..|...............|......................
.. ......................................
..#...............|......................
.. ...............*......................
..|...............|......................
..*- - - - - - - -*......................
.........................................
.........................................
.........................................
.........................................
.........................................
.........................................
.........................................
.........................................
.........................................
........*-*-*............................
........|0 0|............................
........*-*-*............................
.........................................
.........................................
.........................................
.........................................

.........................................
.........................................
.........................................
.........................................
..*- -*.*- - - - -*......................
..|...............|......................
.. ............... ......................
..|...............|......................
.. ...............*......................
..|...............|......................
.. ...............*......................
..|...............|......................
..*- - - - - - - -*......................
.........................................
.........................................
.........................................
.........................................
.........................................
.........................................
.........................................
.........................................
.........................................
.........................................
........./...............................
.........................................
.........................................
.........................................
.........................................
.........................................

.........................................
.........................................
.........................................
.........................................
..*- -*.*- -*.*- -*......................
..|...............|......................
.. ............... ......................
..|...............|......................
.. ...............*......................
..|...............|......................
.. ...............*......................
..|...............|......................
..*- -*.*- -*.*- -*......................
.........................................
.........................................
.........................................
.........................................
.........................................
.........................................
.........................................
.........................................
.........................................
..........*-----*........................
..........|00000|........................
..........*-----*........................
.........................................
.........................................
.........................................
.........................................

.........................................
.........................................
.........................................
.........................................
..*- -*.*- - - - -*......................
..|///////////////|......................
.. /////////////// ......................
..|///////////////|......................
.. ///////////////*......................
..|///////////////|......................
.. ///////////////*......................
..|///////////////|......................
..*- - - - - - - -*......................
.........................................
.........................................
.........................................
.........................................
.........................................
.........................................
.........................................
.........................................
.........................................
.........................................
.........../////.........................
.........................................
.........................................
.........................................
.........................................
.........................................

.........................................
.........................................
.........................................
.........................................
.........................................
.........................................
.........................................
.........................................
.........................................
.........................................
.........................................
.........................................
.........................................
.........................................
.........................................
.........................................
.........................................
.........................................
.........................................
.........................................
.........................................
.........................................
.........................................
.........................................
.........................................
.........................................
.........................................
.........................................
.........................................

.........................................
.........................................
.........................................
.........................................
.........................................
.........................................
.........................................
.........................................
.........................................
.........................................
.........................................
.........................................
.........................................
.........................................
.........................................
.........................................
.........................................
.........................................
.........................................
.........................................
.........................................
.........................................
.........................................
.........................................
.........................................
.........................................
.........................................
.........................................
.........................................
